29 42
111111111111111111111111111111111111111111
120000000000000110000000000000000000000001
100010011100100010001110111110111111111101
101111110100111010000010100010001000001001
101000010111100011111011110010001001111111
101001010000000010001010000010001000100001
101011010111100010001011000010001100100001
101010010100111110001001000010000111100001
100010110100000010001001000011110100000001
100010100101111011101001001000010100101001
101110100000101010101001000001110111111101
101010111110101000101001000100000101010101
100010000010101001101001000100100100000001
100111011110100011001101000100000111000001
100001010000100000000001101100100000000001
100111011111111111110110000011100000100001
100100000000000000100010000010001010010001
100111110001111100100010111111001010010001
100000010000000100111010100000001111110001
101110011011011100001000100000001000000001
101000100001010000111101111111111011111011
101010000001110000000000000100001010100011
101010111111000111111111000000000010111011
101011100000000100000101111111101110010001
101000100100000100100100100100000000010101
101101110111111111100100110111111110010001
100000100001000000000111000000001000011001
100000100001000000000000000000100000000031
111111111111111111111111111111111111111111